16
1111111111111111
1000010000000100
1000010000010101
1011111110111101
1010000000100101
1010000000110101
1010011100000001
1010010000111111
1000010000000101
1011011100100101
1010010000100101
1010010111110101
1010010100000101
1010000100111101
1010010000000001
1111111111111111
