32
11111111111111111111111111111111
10000000100000000000001000010000
11110100111110000011111001000101
10010100100000011110000001001101
10000100001001000010110001111111
10000100101001000110100001000001
11110101100001001100111001100001
10000100001101000100100000001101
10000000001111110100111100000101
10000011000000000100100000011111
10011111111100000000000000000001
10000000000001111110111111000001
10001000010000100110100100000101
10011000010000100000000110100101
10011000011011100101000000110101
10011110010010000101010000100001
10010011010011000101010010111111
10010001000011110101111110100001
10000001000000000100000000100001
10000001011110100100010100100001
10111111000000100101010110101111
10100000000000110101010010000001
10100000000000010001110000000001
10001111111111000011111110000111
10000100011000000000000000000001
10100000011010111000100111111001
10100000011010010000100100001001
10100000000010111110100110001001
11111100100110000000100100001101
10000000111111111000100111100101
10000000000000001000100000000001
11111111111111111111111111111111
