24
111111111111111111111111
100000000000000000000100
101111111011111110000101
100000010010000010011101
111110000011100011000101
100000000000000001000101
100111111111000000000101
100000000001000000000101
101111111111001111100101
101000000000001000100101
101110010001001000100001
100010010001111000101101
101110010000000000101001
101000010001000000101001
101000000101000000101001
100001111101000000101111
101001000001000010100001
101101000001000010100001
100000001001111111101001
101110001000000000101001
101000001000010000101001
101001111110010000001001
101000000000011100001001
111111111111111111111111

